2 2 2 2 2 2 2 2 2 2 2 2 2 2 2 2 2 2 2 2 2 2 2 2 2 2 2 2 2 2 2 2 2 2 2 2 2 2 2 2 2 2 2 2 2 2 2 2 2 2 2 2 2 2 2 2 2 2 2 2 2 2 2 2 2 2 2 2 2 2 2 2 2 2 2 2 2 2 2 2 2 2 2 2 2 2 2 2 2 2 2 2 2 2 2 2 2 2 2 2 2 2 2  
2 2 2 2 2 2 2 2 2 2 2 2 2 2 2 2 2 2 2 2 2 2 2 2 2 2 2 2 2 2 2 2 2 2 2 2 2 2 2 2 2 2 2 2 2 2 2 2 2 2 2 2 2 2 2 2 2 2 2 2 2 2 2 2 2 2 2 2 2 2 2 2 2 2 2 2 2 2 2 2 2 2 2 2 2 2 2 2 2 2 2 2 2 2 2 2 2 2 2 2 2 2 2 
2 2 2 2 2 2 2 2 2 2 2 2 2 2 2 2 2 2 2 2 2 2 2 2 2 2 2 2 2 2 2 2 2 2 2 2 2 2 2 2 2 2 2 2 2 2 2 2 2 2 2 2 2 2 2 2 2 2 2 2 2 2 2 2 2 2 2 2 2 2 2 2 2 2 2 2 2 2 2 2 2 2 2 2 2 2 2 2 2 2 2 2 2 2 2 2 2 2 2 2 2 2 2 
2 2 2 2 2 2 2 2 2 2 2 2 2 2 2 2 2 2 2 2 2 2 2 2 2 2 2 2 2 2 2 2 2 2 2 2 2 2 2 2 2 2 2 2 2 2 2 2 2 2 2 2 2 2 2 2 2 2 2 2 2 2 2 2 2 2 2 2 2 2 2 2 2 2 2 2 2 2 2 2 2 2 2 2 2 2 2 2 2 2 2 2 2 2 2 2 2 2 2 2 2 2 2 
2 2 2 2 2 2 2 2 2 2 2 2 2 2 2 2 2 2 2 2 2 2 2 2 2 2 2 2 2 2 2 2 2 2 2 2 2 2 2 2 2 2 2 2 2 2 2 2 2 2 2 2 2 2 2 2 2 2 2 2 2 2 2 2 2 2 2 2 2 2 2 2 2 2 2 2 2 2 2 2 2 2 2 2 2 2 2 2 2 2 2 2 2 2 2 2 2 2 2 2 2 2 2 
2 2 2 2 2 2 2 2 2 2 2 2 2 2 2 2 2 2 2 2 2 2 2 2 2 2 2 2 2 2 2 2 2 2 2 2 2 2 2 2 2 2 2 2 2 2 2 2 2 2 2 2 2 2 2 2 2 2 2 2 2 2 2 2 2 2 2 2 2 2 2 2 2 2 2 2 2 2 2 2 2 2 2 2 2 2 2 2 2 2 2 2 2 2 2 2 2 2 2 2 2 2 2 
2 2 2 2 2 2 2 2 2 2 2 2 2 2 2 2 2 2 2 2 2 2 2 2 2 2 2 2 2 2 2 2 2 2 2 2 2 2 2 2 2 2 2 2 2 2 2 2 2 2 2 2 2 2 2 2 2 2 2 2 2 2 2 2 2 2 2 2 2 2 2 2 2 2 2 2 2 2 2 2 2 2 2 2 2 2 2 2 2 2 2 2 2 2 2 2 2 2 2 2 2 2 2 
2 2 2 2 2 2 2 2 2 2 2 2 2 2 2 2 2 2 2 2 2 2 2 2 2 2 2 2 2 2 2 2 2 2 2 2 2 2 2 2 2 2 2 2 2 2 2 2 2 2 2 2 2 2 2 2 2 2 2 2 2 2 2 2 2 2 2 2 2 2 2 2 2 2 2 2 2 2 2 2 2 2 2 2 2 2 2 2 2 2 2 2 2 2 2 2 2 2 2 2 2 2 2 
2 2 2 2 2 2 2 2 2 2 19 20 20 20 20 20 20 20 20 20 20 20 20 20 20 20 20 20 20 20 20 21 2 2 2 2 2 2 2 2 2 9 10 10 10 10 10 10 10 10 10 10 10 10 10 10 10 10 10 10 10 11 2 2 2 2 2 2 2 2 2 29 30 30 30 30 30 30 30 30 30 30 30 30 30 30 30 30 30 30 30 30 4 4 4 4 3 3 3 2 2 2 2 
2 2 2 2 2 2 2 2 2 2 18 14 14 14 14 14 14 14 14 14 14 14 14 14 14 14 14 14 14 14 14 22 2 2 2 2 2 2 2 2 2 8 0 0 0 0 0 0 0 0 0 0 0 0 0 0 0 0 0 0 0 12 2 2 2 2 2 2 2 2 2 28 5 5 5 5 5 5 5 5 5 5 5 5 5 5 5 5 5 5 5 5 4 4 4 3 3 3 2 2 2 2 2
2 2 2 2 2 2 2 2 2 2 18 14 14 15 15 15 15 14 14 15 15 15 15 14 15 15 15 15 15 15 14 22 2 2 2 2 2 2 2 2 2 8 0 0 0 0 0 0 0 0 0 0 0 0 0 0 0 0 0 0 0 12 2 2 2 2 2 2 2 2 2 28 5 5 5 5 5 5 5 5 5 5 5 5 5 5 5 5 5 5 5 4 4 4 3 3 3 2 2 2 2 2 2
2 2 2 2 2 2 2 2 2 2 18 14 15 15 15 16 16 16 14 15 16 16 16 15 15 16 16 16 16 16 14 22 2 2 2 2 2 2 2 2 2 8 0 0 0 0 0 0 0 0 0 0 0 0 0 0 0 0 0 0 0 12 2 2 2 2 2 2 2 2 2 28 5 5 5 5 5 5 5 5 5 5 5 5 5 5 5 5 5 5 5 5 4 4 4 3 3 3 2 2 2 2 2
2 2 2 2 2 2 2 2 2 2 18 14 15 16 15 16 17 16 15 15 16 17 17 16 15 16 17 17 17 17 14 22 2 2 2 2 2 2 2 2 2 8 0 0 0 0 0 0 0 0 0 0 0 0 0 0 0 0 0 0 0 12 2 2 2 2 2 2 2 2 2 28 5 5 5 5 5 5 5 5 5 5 5 5 5 5 5 5 5 5 5 5 5 4 4 4 3 3 3 2 2 2 2
2 2 2 2 2 2 2 2 2 2 18 14 15 16 16 17 17 16 16 16 16 17 17 16 16 16 17 17 17 17 14 22 2 2 2 2 2 2 2 2 2 8 0 0 0 0 0 0 0 0 0 0 0 0 0 0 0 0 0 0 0 12 2 2 2 2 2 2 2 2 2 28 5 5 5 5 5 5 5 5 5 5 5 5 5 5 5 5 5 5 5 5 5 4 4 4 3 3 3 2 2 2 2
2 2 2 2 2 2 2 2 2 2 18 14 15 16 16 16 17 17 17 17 17 17 17 17 17 17 17 17 17 17 14 22 2 2 2 2 2 2 2 2 2 8 0 0 0 0 0 0 0 0 0 0 0 0 0 0 0 0 0 0 0 12 2 2 2 2 2 2 2 2 2 28 5 5 5 5 5 5 5 5 5 5 5 5 5 5 5 5 5 5 5 5 4 4 4 3 3 3 2 2 2 2 2
2 2 2 2 2 2 2 2 2 2 18 14 14 15 15 16 17 17 17 17 17 17 17 17 17 17 17 17 17 17 14 14 0 0 0 0 0 0 0 0 0 8 0 0 0 0 0 0 0 0 0 0 0 0 0 0 0 0 0 0 0 12 0 0 0 0 0 0 0 0 0 28 5 5 5 5 5 5 5 5 5 5 5 5 5 5 5 5 5 5 5 4 4 4 3 3 3 2 2 2 2 2 2
2 2 2 2 2 2 2 2 2 2 18 14 14 15 16 16 17 17 17 17 17 17 17 17 17 17 17 17 17 17 14 14 0 0 0 0 0 0 0 0 0 8 0 0 0 0 0 0 0 0 0 0 0 0 0 0 0 0 0 0 0 12 0 0 0 0 0 0 0 0 0 28 5 5 5 5 5 5 5 5 5 5 5 5 5 5 5 5 5 5 5 5 5 4 4 4 3 3 3 2 2 2 2
2 2 2 2 2 2 2 2 2 2 18 14 15 16 17 17 17 17 17 17 17 17 17 17 17 17 17 17 17 17 14 14 0 0 0 0 0 0 0 0 0 8 0 0 0 0 0 0 0 0 0 0 0 0 0 0 0 0 0 0 0 12 0 0 0 0 0 0 0 0 0 28 5 5 5 5 5 5 5 5 5 5 5 5 5 5 5 5 5 5 5 5 5 4 4 4 3 3 3 2 2 2 2
2 2 2 2 2 2 2 2 2 2 18 14 15 15 16 17 17 17 17 17 17 17 17 17 17 17 17 17 17 17 14 22 2 2 2 2 2 2 2 2 2 8 0 0 0 0 0 0 0 0 0 0 0 0 0 0 0 0 0 0 0 12 2 2 2 2 2 2 2 2 2 28 5 5 5 5 5 5 5 5 5 5 5 5 5 5 5 5 5 5 5 5 4 4 4 3 3 3 2 2 2 2 2
2 2 2 2 2 2 2 2 2 2 18 14 14 16 17 17 17 17 17 17 17 17 17 17 17 17 17 17 17 17 14 22 2 2 2 2 2 2 2 2 2 8 0 0 0 0 0 0 0 0 0 0 0 0 0 0 0 0 0 0 0 12 2 2 2 2 2 2 2 2 2 28 5 5 5 5 5 5 5 5 5 5 5 5 5 5 5 5 5 5 5 5 4 4 4 3 3 3 2 2 2 2 2
2 2 2 2 2 2 2 2 2 2 18 14 14 15 16 17 17 17 17 17 17 17 17 17 17 17 17 17 17 17 14 22 2 2 2 2 2 2 2 2 2 8 0 0 0 0 0 0 0 0 0 0 0 0 0 0 0 0 0 0 0 12 2 2 2 2 2 2 2 2 2 28 5 5 5 5 5 5 5 5 5 5 5 5 5 5 5 5 5 5 5 5 4 4 4 3 3 3 2 2 2 2 2
2 2 2 2 2 2 2 2 2 2 18 14 15 15 16 17 17 17 17 17 17 17 17 17 17 17 17 17 17 17 14 22 2 2 2 2 2 2 2 2 2 8 0 0 0 0 0 0 0 0 0 0 0 0 0 0 0 0 0 0 0 12 2 2 2 2 2 2 2 2 2 28 5 5 5 5 5 5 5 5 5 5 5 5 5 5 5 5 5 5 5 4 4 4 3 3 3 2 2 2 2 2 2
2 2 2 2 2 2 2 2 2 2 18 14 15 16 17 17 17 17 17 17 17 17 17 17 17 17 17 17 17 17 14 22 2 2 2 2 2 2 2 2 2 8 0 0 0 0 0 0 0 0 0 0 0 0 0 0 0 0 0 0 0 12 2 2 2 2 2 2 2 2 2 28 5 5 5 5 5 5 5 5 5 5 5 5 5 5 5 5 5 5 5 4 4 4 3 3 3 2 2 2 2 2 2
2 2 2 2 2 2 2 2 2 2 18 14 15 16 17 17 17 17 17 17 17 17 17 17 17 17 17 17 17 17 14 22 2 2 2 2 2 2 2 2 2 8 0 0 0 0 0 0 0 0 0 0 0 0 0 0 0 0 0 0 0 12 2 2 2 2 2 2 2 2 2 28 5 5 5 5 5 5 5 5 5 5 5 5 5 5 5 5 5 5 5 5 5 4 4 4 3 3 3 2 2 2 2
2 2 2 2 2 2 2 2 2 2 18 14 15 16 17 17 17 17 17 17 17 17 17 17 17 17 17 17 17 17 14 22 2 2 2 2 2 2 2 2 2 7 6 6 6 6 6 6 6 6 6 6 6 6 6 6 6 6 6 6 6 13 2 2 2 2 2 2 2 2 2 28 5 5 5 5 5 5 5 5 5 5 5 5 5 5 5 5 5 5 5 5 5 4 4 4 3 3 3 2 2 2 2
2 2 2 2 2 2 2 2 2 2 18 14 14 15 16 16 17 17 17 17 17 17 17 17 17 17 17 17 17 17 14 22 2 2 2 2 2 2 2 2 2 2 2 2 2 2 2 2 2 2 0 0 0 2 2 2 2 2 2 2 2 2 2 2 2 2 2 2 2 2 2 28 5 5 5 5 5 5 5 5 5 5 5 5 5 5 5 5 5 5 5 5 4 4 4 3 3 3 2 2 2 2 2
2 2 2 2 2 2 2 2 2 2 18 14 15 16 17 17 17 17 17 17 17 17 17 17 17 17 17 17 17 17 14 22 2 2 2 2 2 2 2 2 2 2 2 2 2 2 2 2 2 2 0 0 0 2 2 2 2 2 2 2 2 2 2 2 2 2 2 2 2 2 2 28 5 5 5 5 5 5 5 5 5 5 5 5 5 5 5 5 5 5 5 4 4 4 3 3 3 2 2 2 2 2 2
2 2 2 2 2 2 2 2 2 2 18 14 15 16 17 17 17 17 17 17 17 17 17 17 17 17 17 17 17 17 14 22 2 2 2 2 2 2 2 2 2 2 2 2 2 2 2 2 2 2 0 0 0 2 2 2 2 2 2 2 2 2 2 2 2 2 2 2 2 2 2 28 5 5 5 5 5 5 5 5 5 5 5 5 5 5 5 5 5 5 5 5 4 4 4 3 3 3 2 2 2 2 2
2 2 2 2 2 2 2 2 2 2 18 14 15 15 16 17 17 17 17 17 17 17 17 17 17 17 17 17 17 17 14 22 2 2 2 2 2 2 2 2 2 2 2 2 2 2 2 2 2 2 0 0 0 2 2 2 2 2 2 2 2 2 2 2 2 2 2 2 2 2 2 28 5 5 5 5 5 5 5 5 5 5 5 5 5 5 5 5 5 5 5 5 5 4 4 4 3 3 3 2 2 2 2
2 2 2 2 2 2 2 2 2 2 18 14 14 15 16 17 17 17 17 17 17 17 17 17 17 17 17 17 17 17 14 22 2 2 2 2 2 2 2 2 2 2 2 2 2 2 2 2 2 2 0 0 0 2 2 2 2 2 2 2 2 2 2 2 2 2 2 2 2 2 2 28 5 5 5 5 5 5 5 5 5 5 5 5 5 5 5 5 5 5 5 5 5 4 4 4 3 3 3 2 2 2 2
2 2 2 2 2 2 2 2 2 2 18 14 14 16 17 17 17 17 17 17 17 17 17 17 17 17 17 17 17 17 14 22 2 2 2 2 2 2 2 2 2 2 2 2 2 2 2 2 2 2 0 0 0 2 2 2 2 2 2 2 2 2 2 2 2 2 2 2 2 2 2 28 5 5 5 5 5 5 5 5 5 5 5 5 5 5 5 5 5 5 5 5 4 4 4 3 3 3 2 2 2 2 2
2 2 2 2 2 2 2 2 2 2 18 14 15 15 16 17 17 17 17 17 17 17 17 17 17 17 17 17 17 17 14 22 2 2 2 2 2 2 2 2 2 2 2 2 2 2 2 2 2 2 0 0 0 2 2 2 2 2 2 2 2 2 2 2 2 2 2 2 2 2 2 28 5 5 5 5 5 5 5 5 5 5 5 5 5 5 5 5 5 5 5 4 4 4 3 3 3 2 2 2 2 2 2
2 2 2 2 2 2 2 2 2 2 18 14 15 16 17 17 17 17 17 17 17 17 17 17 17 17 17 17 17 17 14 22 2 2 2 2 2 2 2 2 2 2 2 2 2 2 2 2 2 2 0 0 0 2 2 2 2 2 2 2 2 2 2 2 2 2 2 2 2 2 2 28 5 5 5 5 5 5 5 5 5 5 5 5 5 5 5 5 5 5 5 4 4 4 3 3 3 2 2 2 2 2 2
2 2 2 2 2 2 2 2 2 2 18 14 14 15 16 16 17 17 17 17 17 17 17 17 17 17 17 17 17 17 14 22 2 2 2 2 2 2 2 2 2 9 10 10 10 10 10 10 10 10 10 10 10 10 10 10 10 10 10 10 10 11 2 2 2 2 2 2 2 2 2 28 5 5 5 5 5 5 5 5 5 5 5 5 5 5 5 5 5 5 5 5 5 4 4 4 3 3 3 2 2 2 2
2 2 2 2 2 2 2 2 2 2 18 14 15 16 17 17 17 17 17 17 17 17 17 17 17 17 17 17 17 17 14 22 2 2 2 2 2 2 2 2 2 8 0 0 0 0 0 0 0 0 0 0 0 0 0 0 0 0 0 0 0 12 2 2 2 2 2 2 2 2 2 28 5 5 5 5 5 5 5 5 5 5 5 5 5 5 5 5 5 5 5 5 5 4 4 4 3 3 3 2 2 2 2
2 2 2 2 2 2 2 2 2 2 18 14 15 16 17 17 17 17 17 17 17 17 17 17 17 17 17 17 17 17 14 22 2 2 2 2 2 2 2 2 2 8 0 0 0 0 0 0 0 0 0 0 0 0 0 0 0 0 0 0 0 12 2 2 2 2 2 2 2 2 2 28 5 5 5 5 5 5 5 5 5 5 5 5 5 5 5 5 5 5 5 5 4 4 4 3 3 3 2 2 2 2 2
2 2 2 2 2 2 2 2 2 2 18 14 15 15 16 17 17 17 17 17 17 17 17 17 17 17 17 17 17 17 14 22 2 2 2 2 2 2 2 2 2 8 0 0 0 0 0 0 0 0 0 0 0 0 0 0 0 0 0 0 0 12 2 2 2 2 2 2 2 2 2 28 5 5 5 5 5 5 5 5 5 5 5 5 5 5 5 5 5 5 5 5 5 4 4 4 3 3 3 2 2 2 2
2 2 2 2 2 2 2 2 2 2 18 14 14 15 16 17 17 17 17 17 17 17 17 17 17 17 17 17 17 17 14 22 2 2 2 2 2 2 2 2 2 8 0 0 0 0 0 0 0 0 0 0 0 0 0 0 0 0 0 0 0 12 2 2 2 2 2 2 2 2 2 28 5 5 5 5 5 5 5 5 5 5 5 5 5 5 5 5 5 5 5 5 5 4 4 4 3 3 3 2 2 2 2
2 2 2 2 2 2 2 2 2 2 18 14 14 16 17 17 17 17 17 17 17 17 17 17 17 17 17 17 17 17 14 22 2 2 2 2 2 2 2 2 2 8 0 0 0 0 0 0 0 0 0 0 0 0 0 0 0 0 0 0 0 12 2 2 2 2 2 2 2 2 2 28 5 5 5 5 5 5 5 5 5 5 5 5 5 5 5 5 5 5 5 5 4 4 4 3 3 3 2 2 2 2 2
2 2 2 2 2 2 2 2 2 2 18 14 15 15 16 17 17 17 17 17 17 17 17 17 17 17 17 17 17 17 14 22 2 2 2 2 2 2 2 2 2 8 0 0 0 0 0 0 0 0 0 0 0 0 0 0 0 0 0 0 0 12 2 2 2 2 2 2 2 2 2 28 5 5 5 5 5 5 5 5 5 5 5 5 5 5 5 5 5 5 5 5 4 4 4 3 3 3 2 2 2 2 2
2 2 2 2 2 2 2 2 2 2 18 14 15 16 17 17 17 17 17 17 17 17 17 17 17 17 17 17 17 17 14 22 0 0 0 0 0 0 0 0 0 8 0 0 0 0 0 0 0 0 0 0 0 0 0 0 0 0 0 0 0 12 2 2 2 2 2 2 2 2 2 28 5 5 5 5 5 5 5 5 5 5 5 5 5 5 5 5 5 5 5 5 5 4 4 4 3 3 3 2 2 2 2
2 2 2 2 2 2 2 2 2 2 18 14 14 15 16 16 17 17 17 17 17 17 17 17 17 17 17 17 17 17 14 22 0 0 0 0 0 0 0 0 0 8 0 0 0 0 0 0 0 0 0 0 0 0 0 0 0 0 0 0 0 12 2 2 2 2 2 2 2 2 2 28 5 5 5 5 5 5 5 5 5 5 5 5 5 5 5 5 5 5 5 5 4 4 4 3 3 3 2 2 2 2 2
2 2 2 2 2 2 2 2 2 2 18 14 15 16 17 17 17 17 17 17 17 17 17 17 17 17 17 17 17 17 14 22 0 0 0 0 0 0 0 0 0 8 0 0 0 0 0 0 0 0 0 0 0 0 0 0 0 0 0 0 0 12 2 2 2 2 2 2 2 2 2 28 5 5 5 5 5 5 5 5 5 5 5 5 5 5 5 5 5 5 5 5 4 4 4 3 3 3 2 2 2 2 2
2 2 2 2 2 2 2 2 2 2 18 14 15 16 17 17 17 17 17 17 17 17 17 17 17 17 17 17 17 17 14 22 2 2 2 2 2 2 2 2 2 8 0 0 0 0 0 0 0 0 0 0 0 0 0 0 0 0 0 0 0 12 2 2 2 2 2 2 2 2 2 28 5 5 5 5 5 5 5 5 5 5 5 5 5 5 5 5 5 5 5 4 4 4 3 3 3 2 2 2 2 2 2
2 2 2 2 2 2 2 2 2 2 18 14 15 15 16 17 17 17 17 17 17 17 17 17 17 17 17 17 17 17 14 22 2 2 2 2 2 2 2 2 2 8 0 0 0 0 0 0 0 0 0 0 0 0 0 0 0 0 0 0 0 12 2 2 2 2 2 2 2 2 2 28 5 5 5 5 5 5 5 5 5 5 5 5 5 5 5 5 5 5 5 5 4 4 4 3 3 3 2 2 2 2 2
2 2 2 2 2 2 2 2 2 2 18 14 14 15 16 17 17 17 17 17 17 17 17 17 17 17 17 17 17 17 14 22 2 2 2 2 2 2 2 2 2 8 0 0 0 0 0 0 0 0 0 0 0 0 0 0 0 0 0 0 0 12 2 2 2 2 2 2 2 2 2 28 5 5 5 5 5 5 5 5 5 5 5 5 5 5 5 5 5 5 5 4 4 4 3 3 3 2 2 2 2 2 2
2 2 2 2 2 2 2 2 2 2 18 14 14 16 17 17 17 17 17 17 17 17 17 17 17 17 17 17 17 17 14 22 2 2 2 2 2 2 2 2 2 8 0 0 0 0 0 0 0 0 0 0 0 0 0 0 0 0 0 0 0 12 2 2 2 2 2 2 2 2 2 28 5 5 5 5 5 5 5 5 5 5 5 5 5 5 5 5 5 5 5 4 4 4 3 3 3 2 2 2 2 2 2
2 2 2 2 2 2 2 2 2 2 18 14 15 15 16 17 17 17 17 17 17 17 17 17 17 17 17 17 17 17 14 22 2 2 2 2 2 2 2 2 2 8 0 0 0 0 0 0 0 0 0 0 0 0 0 0 0 0 0 0 0 12 2 2 2 2 2 2 2 2 2 28 5 5 5 5 5 5 5 5 5 5 5 5 5 5 5 5 5 5 5 5 4 4 4 3 3 3 2 2 2 2 2
2 2 2 2 2 2 2 2 2 2 18 14 15 16 17 17 17 17 17 17 17 17 17 17 17 17 17 17 17 17 14 22 2 2 2 2 2 2 2 2 2 8 0 0 0 0 0 0 0 0 0 0 0 0 0 0 0 0 0 0 0 12 2 2 2 2 2 2 2 2 2 28 5 5 5 5 5 5 5 5 5 5 5 5 5 5 5 5 5 5 5 4 4 4 3 3 3 2 2 2 2 2 2
2 2 2 2 2 2 2 2 2 2 18 14 14 15 16 16 17 17 17 17 17 17 17 17 17 17 17 17 17 17 14 22 2 2 2 2 2 2 2 2 2 7 6 6 6 6 6 6 6 6 0 0 6 6 6 6 6 6 6 6 6 13 2 2 2 2 2 2 2 2 2 28 5 5 5 5 5 5 5 5 5 5 5 5 5 5 5 5 5 5 5 5 5 4 4 4 3 3 3 2 2 2 2
2 2 2 2 2 2 2 2 2 2 18 14 15 16 17 17 17 17 17 17 17 17 17 17 17 17 17 17 17 17 14 22 2 2 2 2 2 2 2 2 2 2 2 2 2 2 2 2 2 2 0 0 0 2 2 2 2 2 2 2 2 2 2 2 2 2 2 2 2 2 2 28 5 5 5 5 5 5 5 5 5 5 5 5 5 5 5 5 5 5 5 5 5 4 4 4 3 3 3 2 2 2 2
2 2 2 2 2 2 2 2 2 2 18 14 15 16 17 17 17 17 17 17 17 17 17 17 17 17 17 17 17 17 14 22 2 2 2 2 2 2 2 2 2 2 2 2 2 2 2 2 2 2 0 0 0 2 2 2 2 2 2 2 2 2 2 2 2 2 2 2 2 2 2 28 5 5 5 5 5 5 5 5 5 5 5 5 5 5 5 5 5 5 5 5 5 4 4 4 3 3 3 2 2 2 2
2 2 2 2 2 2 2 2 2 2 18 14 15 15 16 17 17 17 17 17 17 17 17 17 17 17 17 17 17 17 14 22 2 2 2 2 2 2 2 2 2 2 2 2 2 2 2 2 2 2 0 0 0 2 2 2 2 2 2 2 2 2 2 2 2 2 2 2 2 2 2 28 5 5 5 5 5 5 5 5 5 5 5 5 5 5 5 5 5 5 5 5 5 4 4 4 3 3 3 2 2 2 2
2 2 2 2 2 2 2 2 2 2 18 14 14 15 16 17 17 17 17 17 17 17 17 17 17 17 17 17 17 17 14 22 2 2 2 2 2 2 2 2 2 2 2 2 2 2 2 2 2 2 0 0 0 2 2 2 2 2 2 2 2 2 2 2 2 2 2 2 2 2 2 28 5 5 5 5 5 5 5 5 5 5 5 5 5 5 5 5 5 5 5 4 4 4 3 3 3 2 2 2 2 2 2
2 2 2 2 2 2 2 2 2 2 18 14 14 16 17 17 17 17 17 17 17 17 17 17 17 17 17 17 17 17 14 22 2 2 2 2 2 2 2 2 2 2 2 2 2 2 2 2 2 2 0 0 0 2 2 2 2 2 2 2 2 2 2 2 2 2 2 2 2 2 2 28 5 5 5 5 5 5 5 5 5 5 5 5 5 5 5 5 5 5 5 4 4 4 3 3 3 2 2 2 2 2 2
2 2 2 2 2 2 2 2 2 2 18 14 15 15 16 17 17 17 17 17 17 17 17 17 17 17 17 17 17 17 14 22 2 2 2 2 2 2 2 2 2 2 2 2 2 2 2 2 2 2 0 0 0 2 2 2 2 2 2 2 2 2 2 2 2 2 2 2 2 2 2 28 5 5 5 5 5 5 5 5 5 5 5 5 5 5 5 5 5 5 5 4 4 4 3 3 3 2 2 2 2 2 2
2 2 2 2 2 2 2 2 2 2 18 14 15 16 17 17 17 17 17 17 17 17 17 17 17 17 17 17 17 17 14 22 2 2 2 2 2 2 2 2 2 2 2 2 2 2 2 2 2 2 0 0 0 2 2 2 2 2 2 2 2 2 2 2 2 2 2 2 2 2 2 28 5 5 5 5 5 5 5 5 5 5 5 5 5 5 5 5 5 5 5 5 4 4 4 3 3 3 2 2 2 2 2
2 2 2 2 2 2 2 2 2 2 18 14 14 15 16 16 17 17 17 17 17 17 17 17 17 17 17 17 17 17 14 22 2 2 2 2 2 2 2 2 2 9 10 10 10 10 10 10 10 10 10 10 10 10 10 10 10 10 10 10 10 11 2 2 2 2 2 2 2 2 2 28 5 5 5 5 5 5 5 5 5 5 5 5 5 5 5 5 5 5 5 5 4 4 4 3 3 3 2 2 2 2 2
2 2 2 2 2 2 2 2 2 2 18 14 15 16 17 17 17 17 17 17 17 17 17 17 17 17 17 17 17 17 14 22 2 2 2 2 2 2 2 2 2 8 0 0 0 0 0 0 0 0 0 0 0 0 0 0 0 0 0 0 0 12 2 2 2 2 2 2 2 2 2 28 5 5 5 5 5 5 5 5 5 5 5 5 5 5 5 5 5 5 5 4 4 4 3 3 3 2 2 2 2 2 2
2 2 2 2 2 2 2 2 2 2 18 14 15 16 17 17 17 17 17 17 17 17 17 17 17 17 17 17 17 17 14 22 2 2 2 2 2 2 2 2 2 8 0 0 0 0 0 0 0 0 0 0 0 0 0 0 0 0 0 0 0 12 2 2 2 2 2 2 2 2 2 28 5 5 5 5 5 5 5 5 5 5 5 5 5 5 5 5 5 5 5 5 5 4 4 4 3 3 3 2 2 2 2
2 2 2 2 2 2 2 2 2 2 18 14 15 15 16 17 17 17 17 17 17 17 17 17 17 17 17 17 17 17 14 22 2 2 2 2 2 2 2 2 2 8 0 0 0 0 0 0 0 0 0 0 0 0 0 0 0 0 0 0 0 12 2 2 2 2 2 2 2 2 2 28 5 5 5 5 5 5 5 5 5 5 5 5 5 5 5 5 5 5 5 5 5 4 4 4 3 3 3 2 2 2 2
2 2 2 2 2 2 2 2 2 2 18 14 14 15 16 17 17 17 17 17 17 17 17 17 17 17 17 17 17 17 14 22 2 2 2 2 2 2 2 2 2 8 0 0 0 0 0 0 0 0 0 0 0 0 0 0 0 0 0 0 0 12 2 2 2 2 2 2 2 2 2 28 5 5 5 5 5 5 5 5 5 5 5 5 5 5 5 5 5 5 5 5 4 4 4 3 3 3 2 2 2 2 2
2 2 2 2 2 2 2 2 2 2 18 14 14 16 17 17 17 17 17 17 17 17 17 17 17 17 17 17 17 17 14 22 2 2 2 2 2 2 2 2 2 8 0 0 0 0 0 0 0 0 0 0 0 0 0 0 0 0 0 0 0 12 2 2 2 2 2 2 2 2 2 28 5 5 5 5 5 5 5 5 5 5 5 5 5 5 5 5 5 5 5 4 4 4 3 3 3 2 2 2 2 2 2
2 2 2 2 2 2 2 2 2 2 18 14 15 15 16 17 17 17 17 17 17 17 17 17 17 17 17 17 17 17 14 22 2 2 2 2 2 2 2 2 2 8 0 0 0 0 0 0 0 0 0 0 0 0 0 0 0 0 0 0 0 12 2 2 2 2 2 2 2 2 2 28 5 5 5 5 5 5 5 5 5 5 5 5 5 5 5 5 5 5 5 4 4 4 3 3 3 2 2 2 2 2 2
2 2 2 2 2 2 2 2 2 2 18 14 15 16 17 17 17 17 17 17 17 17 17 17 17 17 17 17 17 17 14 22 0 0 0 0 0 0 0 0 0 8 0 0 0 0 0 0 0 0 0 0 0 0 0 0 0 0 0 0 0 12 2 2 2 2 2 2 2 2 2 28 5 5 5 5 5 5 5 5 5 5 5 5 5 5 5 5 5 5 5 4 4 4 3 3 3 2 2 2 2 2 2
2 2 2 2 2 2 2 2 2 2 18 14 14 15 16 16 17 17 17 17 17 17 17 17 17 17 17 17 17 17 14 22 0 0 0 0 0 0 0 0 0 8 0 0 0 0 0 0 0 0 0 0 0 0 0 0 0 0 0 0 0 12 2 2 2 2 2 2 2 2 2 28 5 5 5 5 5 5 5 5 5 5 5 5 5 5 5 5 5 5 5 5 5 4 4 4 3 3 3 2 2 2 2
2 2 2 2 2 2 2 2 2 2 18 14 14 15 15 16 17 17 17 17 17 17 17 17 17 17 17 17 17 17 14 22 0 0 0 0 0 0 0 0 0 8 0 0 0 0 0 0 0 0 0 0 0 0 0 0 0 0 0 0 0 12 2 2 2 2 2 2 2 2 2 28 5 5 5 5 5 5 5 5 5 5 5 5 5 5 5 5 5 5 5 5 5 4 4 4 3 3 3 2 2 2 2
2 2 2 2 2 2 2 2 2 2 18 14 15 16 16 16 17 17 17 17 17 17 17 17 17 17 17 17 17 17 14 22 2 2 2 2 2 2 2 2 2 8 0 0 0 0 0 0 0 0 0 0 0 0 0 0 0 0 0 0 0 12 2 2 2 2 2 2 2 2 2 28 5 5 5 5 5 5 5 5 5 5 5 5 5 5 5 5 5 5 5 5 4 4 4 3 3 3 2 2 2 2 2
2 2 2 2 2 2 2 2 2 2 18 14 15 16 16 17 17 16 16 16 16 17 17 16 16 16 17 17 17 17 14 22 2 2 2 2 2 2 2 2 2 8 0 0 0 0 0 0 0 0 0 0 0 0 0 0 0 0 0 0 0 12 2 2 2 2 2 2 2 2 2 28 5 5 5 5 5 5 5 5 5 5 5 5 5 5 5 5 5 5 5 5 4 4 4 3 3 3 2 2 2 2 2
2 2 2 2 2 2 2 2 2 2 18 14 15 16 15 16 17 16 15 15 16 17 17 16 15 16 17 17 17 17 14 22 2 2 2 2 2 2 2 2 2 8 0 0 0 0 0 0 0 0 0 0 0 0 0 0 0 0 0 0 0 12 2 2 2 2 2 2 2 2 2 28 5 5 5 5 5 5 5 5 5 5 5 5 5 5 5 5 5 5 5 4 4 4 3 3 3 2 2 2 2 2 2
2 2 2 2 2 2 2 2 2 2 18 14 15 15 15 16 16 16 14 15 16 16 16 15 15 16 16 16 16 16 14 22 2 2 2 2 2 2 2 2 2 8 0 0 0 0 0 0 0 0 0 0 0 0 0 0 0 0 0 0 0 12 2 2 2 2 2 2 2 2 2 28 5 5 5 5 5 5 5 5 5 5 5 5 5 5 5 5 5 5 5 4 4 4 3 3 3 2 2 2 2 2 2
2 2 2 2 2 2 2 2 2 2 18 14 14 15 15 15 15 14 14 15 15 15 15 14 15 15 15 15 15 15 14 22 2 2 2 2 2 2 2 2 2 8 0 0 0 0 0 0 0 0 0 0 0 0 0 0 0 0 0 0 0 12 2 2 2 2 2 2 2 2 2 28 5 5 5 5 5 5 5 5 5 5 5 5 5 5 5 5 5 5 5 4 4 4 3 3 3 2 2 2 2 2 2
2 2 2 2 2 2 2 2 2 2 18 14 14 14 14 14 14 14 14 14 14 14 14 14 14 14 14 14 14 14 14 22 2 2 2 2 2 2 2 2 2 8 0 0 0 0 0 0 0 0 0 0 0 0 0 0 0 0 0 0 0 12 2 2 2 2 2 2 2 2 2 28 5 5 5 5 5 5 5 5 5 5 5 5 5 5 5 5 5 5 5 5 5 4 4 3 3 3 2 2 2 2 2
2 2 2 2 2 2 2 2 2 2 25 24 24 24 24 24 24 24 24 24 24 24 24 24 24 24 24 24 24 24 24 26 2 2 2 2 2 2 2 2 2 7 6 6 6 6 6 6 6 6 6 6 6 6 6 6 6 6 6 6 6 13 2 2 2 2 2 2 2 2 2 27 31 31 31 31 31 31 31 31 31 31 31 31 31 31 31 31 31 31 31 31 31 2 2 2 2 2 2 2 2 2 2
2 2 2 2 2 2 2 2 2 2 2 2 2 2 2 2 2 2 2 2 2 2 2 2 2 2 2 2 2 2 2 2 2 2 2 2 2 2 2 2 2 2 2 2 2 2 2 2 2 2 2 2 2 2 2 2 2 2 2 2 2 2 2 2 2 2 2 2 2 2 2 2 2 2 2 2 2 2 2 2 2 2 2 2 2 2 2 2 2 2 2 2 2 2 2 2 2 2 2 2 2 2 2
2 2 2 2 2 2 2 2 2 2 2 2 2 2 2 2 2 2 2 2 2 2 2 2 2 2 2 2 2 2 2 2 2 2 2 2 2 2 2 2 2 2 2 2 2 2 2 2 2 2 2 2 2 2 2 2 2 2 2 2 2 2 2 2 2 2 2 2 2 2 2 2 2 2 2 2 2 2 2 2 2 2 2 2 2 2 2 2 2 2 2 2 2 2 2 2 2 2 2 2 2 2 2
2 2 2 2 2 2 2 2 2 2 2 2 2 2 2 2 2 2 2 2 2 2 2 2 2 2 2 2 2 2 2 2 2 2 2 2 2 2 2 2 2 2 2 2 2 2 2 2 2 2 2 2 2 2 2 2 2 2 2 2 2 2 2 2 2 2 2 2 2 2 2 2 2 2 2 2 2 2 2 2 2 2 2 2 2 2 2 2 2 2 2 2 2 2 2 2 2 2 2 2 2 2 2
2 2 2 2 2 2 2 2 2 2 2 2 2 2 2 2 2 2 2 2 2 2 2 2 2 2 2 2 2 2 2 2 2 2 2 2 2 2 2 2 2 2 2 2 2 2 2 2 2 2 2 2 2 2 2 2 2 2 2 2 2 2 2 2 2 2 2 2 2 2 2 2 2 2 2 2 2 2 2 2 2 2 2 2 2 2 2 2 2 2 2 2 2 2 2 2 2 2 2 2 2 2 2
2 2 2 2 2 2 2 2 2 2 2 2 2 2 2 2 2 2 2 2 2 2 2 2 2 2 2 2 2 2 2 2 2 2 2 2 2 2 2 2 2 2 2 2 2 2 2 2 2 2 2 2 2 2 2 2 2 2 2 2 2 2 2 2 2 2 2 2 2 2 2 2 2 2 2 2 2 2 2 2 2 2 2 2 2 2 2 2 2 2 2 2 2 2 2 2 2 2 2 2 2 2 2
2 2 2 2 2 2 2 2 2 2 2 2 2 2 2 2 2 2 2 2 2 2 2 2 2 2 2 2 2 2 2 2 2 2 2 2 2 2 2 2 2 2 2 2 2 2 2 2 2 2 2 2 2 2 2 2 2 2 2 2 2 2 2 2 2 2 2 2 2 2 2 2 2 2 2 2 2 2 2 2 2 2 2 2 2 2 2 2 2 2 2 2 2 2 2 2 2 2 2 2 2 2 2
2 2 2 2 2 2 2 2 2 2 2 2 2 2 2 2 2 2 2 2 2 2 2 2 2 2 2 2 2 2 2 2 2 2 2 2 2 2 2 2 2 2 2 2 2 2 2 2 2 2 2 2 2 2 2 2 2 2 2 2 2 2 2 2 2 2 2 2 2 2 2 2 2 2 2 2 2 2 2 2 2 2 2 2 2 2 2 2 2 2 2 2 2 2 2 2 2 2 2 2 2 2 2
2 2 2 2 2 2 2 2 2 2 2 2 2 2 2 2 2 2 2 2 2 2 2 2 2 2 2 2 2 2 2 2 2 2 2 2 2 2 2 2 2 2 2 2 2 2 2 2 2 2 2 2 2 2 2 2 2 2 2 2 2 2 2 2 2 2 2 2 2 2 2 2 2 2 2 2 2 2 2 2 2 2 2 2 2 2 2 2 2 2 2 2 2 2 2 2 2 2 2 2 2 2 2
