2 2 2 2 2 2 2 2 2 2 2 2 2 2 2 2 2 2 2 2 2 2 2 2 2 2 2 2 2 2 2 2 2 2 2 2 2 2 2 2 2 2 2 2 2 2 2 2 2 2 2 2 2 2 2 2 2 2 2 2 2 2 2 2 2 2 2 2 2 2 2 2 2 2 2 2 2 2 2 2 2 2 2 2 2 2 2 2 2 2 2 2 2 2 2 2 2 2 2 2 2 2 2  
2 2 2 2 2 2 2 2 2 2 2 2 2 2 2 2 2 2 2 2 2 2 2 2 2 2 2 2 2 2 2 2 2 2 2 2 2 2 2 2 2 2 2 2 2 2 2 2 2 2 2 2 2 2 2 2 2 2 2 2 2 2 2 2 2 2 2 2 2 2 2 2 2 2 2 2 2 2 2 2 2 2 2 2 2 2 2 2 2 2 2 2 2 2 2 2 2 2 2 2 2 2 2 
2 2 2 2 2 2 2 2 2 2 2 2 2 2 2 2 2 2 2 2 2 2 2 2 2 2 2 2 2 2 2 2 2 2 2 2 2 2 2 2 2 2 2 2 2 2 2 2 2 2 2 2 2 2 2 2 2 2 2 2 2 2 2 2 2 2 2 2 2 2 2 2 2 2 2 2 2 2 2 2 2 2 2 2 2 2 2 2 2 2 2 2 2 2 2 2 2 2 2 2 2 2 2 
2 2 2 2 2 2 2 2 2 2 2 2 2 2 2 2 2 2 2 2 2 2 2 2 2 2 2 2 2 2 2 2 2 2 2 2 2 2 2 2 2 2 2 2 2 2 2 2 2 2 2 2 2 2 2 2 2 2 2 2 2 2 2 2 2 2 2 2 2 2 2 2 2 2 2 2 2 2 2 2 2 2 2 2 2 2 2 2 2 2 2 2 2 2 2 2 2 2 2 2 2 2 2 
2 2 2 2 2 2 2 2 2 2 2 2 2 2 2 2 2 2 2 2 2 2 2 2 2 2 2 2 2 2 2 2 2 2 2 2 2 2 2 2 2 2 2 2 2 2 2 2 2 2 2 2 2 2 2 2 2 2 2 2 2 2 2 2 2 2 2 2 2 2 2 2 2 2 2 2 2 2 2 2 2 2 2 2 2 2 2 2 2 2 2 2 2 2 2 2 2 2 2 2 2 2 2 
2 2 2 2 2 2 2 2 2 2 2 2 2 2 2 2 2 2 2 2 2 2 2 2 2 2 2 2 2 2 2 2 2 2 2 2 2 2 2 2 2 2 2 2 2 2 2 2 2 2 2 2 2 2 2 2 2 2 2 2 2 2 2 2 2 2 2 2 2 2 2 2 2 2 2 2 2 2 2 2 2 2 2 2 2 2 2 2 2 2 2 2 2 2 2 2 2 2 2 2 2 2 2 
2 2 2 2 2 2 2 2 2 2 2 2 2 2 2 2 2 2 2 2 2 2 2 2 2 2 2 2 2 2 2 2 2 2 2 2 2 2 2 2 2 2 2 2 2 2 2 2 2 2 2 2 2 2 2 2 2 2 2 2 2 2 2 2 2 2 2 2 2 2 2 2 2 2 2 2 2 2 2 2 2 2 2 2 2 2 2 2 2 2 2 2 2 2 2 2 2 2 2 2 2 2 2 
2 2 2 2 2 2 2 2 2 2 2 2 2 2 2 2 2 2 2 2 2 2 2 2 2 2 2 2 2 2 2 2 2 2 2 2 2 2 2 2 2 2 2 2 2 2 2 2 2 2 2 2 2 2 2 2 2 2 2 2 2 2 2 2 2 2 2 2 2 2 2 2 2 2 2 2 2 2 2 2 2 2 2 2 2 2 2 2 2 2 2 2 2 2 2 2 2 2 2 2 2 2 2 
2 2 2 2 2 2 2 2 2 2 19 20 20 20 20 20 20 20 20 20 20 20 20 20 20 20 20 20 20 20 20 21 2 2 2 2 2 2 2 2 2 9 10 10 10 10 10 10 10 10 10 10 10 10 10 10 10 10 10 10 10 11 2 2 2 2 2 2 2 2 2 28 29 29 29 29 29 29 29 29 29 29 29 29 29 29 29 29 29 29 29 29 2 2 2 2 2 2 2 2 2 2 2
2 2 2 2 2 2 2 2 2 2 18 14 14 14 14 14 14 14 14 14 14 14 14 14 14 14 14 14 14 14 14 22 2 2 2 2 2 2 2 2 2 8 0 0 0 0 0 0 0 0 0 0 0 0 0 0 0 0 0 0 0 12 2 2 2 2 2 2 2 2 2 27 5 5 5 5 5 5 5 5 5 5 5 5 5 5 5 5 5 5 5 5 4 4 4 3 3 3 2 2 2 2 2
2 2 2 2 2 2 2 2 2 2 18 14 14 15 14 15 15 14 14 15 15 15 15 14 15 15 15 15 15 15 14 22 2 2 2 2 2 2 2 2 2 8 0 0 0 0 0 0 0 0 0 0 0 0 0 0 0 0 0 0 0 12 2 2 2 2 2 2 2 2 2 27 5 5 5 5 5 5 5 5 5 5 5 5 5 5 5 5 5 5 5 4 4 4 3 3 3 2 2 2 2 2 2
2 2 2 2 2 2 2 2 2 2 18 14 14 14 14 16 16 16 14 15 16 16 16 15 15 16 16 16 16 16 14 22 2 2 2 2 2 2 2 2 2 8 0 0 0 0 0 0 0 0 0 0 0 0 0 0 0 0 0 0 0 12 2 2 2 2 2 2 2 2 2 27 5 5 5 5 5 5 0 0 0 5 5 5 5 5 5 5 5 5 5 5 4 4 4 3 3 3 2 2 2 2 2
2 2 2 2 2 2 2 2 2 2 18 14 15 15 15 16 17 16 15 15 16 17 17 16 15 16 17 16 15 15 14 22 2 2 2 2 2 2 2 2 2 8 0 0 0 0 0 0 0 0 0 0 0 0 0 0 0 0 0 0 0 12 2 2 2 2 2 2 2 2 2 27 5 5 5 5 5 4 3 3 3 4 5 5 5 5 5 5 5 5 5 5 5 4 4 4 3 3 3 2 2 2 2
2 2 2 2 2 2 2 2 2 2 18 14 15 16 16 17 17 16 16 16 16 17 17 16 16 16 17 16 16 15 14 22 2 2 2 2 2 2 2 2 2 8 0 0 0 0 0 0 0 0 0 0 0 0 0 0 0 0 0 0 0 12 2 2 2 2 2 2 2 2 2 27 5 5 5 5 0 3 2 2 2 3 4 5 5 5 5 5 5 5 5 5 5 4 4 4 3 3 3 2 2 2 2
2 2 2 2 2 2 2 2 2 2 18 14 15 16 16 16 17 17 17 17 17 17 17 17 17 17 17 16 16 15 14 22 2 2 2 2 2 2 2 2 2 8 0 0 0 0 0 0 0 0 0 0 0 0 0 0 0 0 0 0 0 12 2 2 2 2 2 2 2 2 2 27 5 5 5 5 0 3 2 2 2 2 3 4 5 5 5 5 5 5 5 5 4 4 4 3 3 3 2 2 2 2 2
2 2 2 2 2 2 2 2 2 2 18 14 14 15 15 16 17 17 17 17 17 17 17 17 17 17 17 15 15 14 14 14 14 14 14 14 14 14 0 0 0 0 0 0 0 0 0 0 0 0 0 0 0 0 0 0 0 0 0 0 0 0 0 0 0 0 0 0 5 5 5 5 5 5 5 5 5 0 3 2 2 2 2 2 3 5 5 5 5 5 5 4 4 4 3 3 3 2 2 2 2 2 2
2 2 2 2 2 2 2 2 2 2 18 14 14 15 16 16 17 17 17 17 17 17 17 17 17 17 17 16 15 15 14 14 14 14 14 14 14 14 0 0 0 0 0 0 0 0 0 0 0 0 0 0 0 0 0 0 0 0 0 0 0 0 0 0 0 0 0 0 5 5 5 5 5 5 5 5 5 5 4 3 3 3 3 3 4 5 5 5 5 5 5 5 5 4 4 4 3 3 3 2 2 2 2
2 2 2 2 2 2 2 2 2 2 18 14 15 16 17 17 17 17 17 17 17 17 17 17 17 17 17 17 16 15 14 14 14 14 14 14 14 14 0 0 0 0 0 0 0 0 0 0 0 0 0 0 0 0 0 0 0 0 0 0 0 0 0 0 0 0 0 0 5 5 5 5 5 5 5 5 5 5 5 0 0 0 0 0 5 5 5 5 5 5 5 5 5 4 4 4 3 3 3 2 2 2 2
2 2 2 2 2 2 2 2 2 2 18 14 15 15 16 17 17 17 17 17 17 17 17 17 17 17 17 16 15 15 14 22 2 2 2 2 2 2 2 2 2 8 0 0 0 0 0 0 0 0 0 0 0 0 0 0 0 0 0 0 0 12 2 2 2 2 2 2 2 2 2 27 5 5 5 5 5 5 5 5 5 5 5 5 5 5 5 5 5 5 5 5 4 4 4 3 3 3 2 2 2 2 2
2 2 2 2 2 2 2 2 2 2 18 14 14 16 17 17 17 17 17 17 17 17 17 17 17 17 17 17 16 14 14 22 2 2 2 2 2 2 2 2 2 8 0 0 0 0 0 0 0 0 0 0 0 0 0 0 0 0 0 0 0 12 2 2 2 2 2 2 2 2 2 27 5 5 5 5 5 5 5 5 5 5 5 5 5 5 5 5 5 5 5 5 4 4 4 3 3 3 2 2 2 2 2
2 2 2 2 2 2 2 2 2 2 18 14 14 15 16 17 17 17 17 17 17 17 17 17 17 17 17 16 15 14 14 22 2 2 2 2 2 2 2 2 2 8 0 0 0 0 0 0 0 0 0 0 0 0 0 0 0 0 0 0 0 12 2 2 2 2 2 2 2 2 2 27 5 5 5 5 5 5 5 5 5 5 5 5 5 5 5 5 5 5 5 5 4 4 4 3 3 3 2 2 2 2 2
2 2 2 2 2 2 2 2 2 2 18 14 15 15 16 17 17 17 17 17 17 17 17 17 17 17 17 16 15 15 14 22 2 2 2 2 2 2 2 2 2 8 0 0 0 0 0 0 0 0 0 0 0 0 0 0 0 0 0 0 0 12 2 2 2 2 2 2 2 2 2 27 5 5 5 5 5 5 5 5 5 5 5 5 5 5 5 5 5 5 5 4 4 4 3 3 3 2 2 2 2 2 2
2 2 2 2 2 2 2 2 2 2 18 14 15 16 17 17 17 17 17 17 17 17 17 17 17 17 17 17 16 15 14 22 2 2 2 2 2 2 2 2 2 8 0 0 0 0 0 0 0 0 0 0 0 0 0 0 0 0 0 0 0 12 2 2 2 2 2 2 2 2 2 27 5 5 5 5 5 5 5 5 5 5 5 5 5 5 5 5 5 5 5 4 4 4 3 3 3 2 2 2 2 2 2
2 2 2 2 2 2 2 2 2 2 18 14 15 16 17 17 17 17 17 17 17 17 17 17 17 17 17 17 16 15 14 22 2 2 2 2 2 2 2 2 2 8 0 0 0 0 0 0 0 0 0 0 0 0 0 0 0 0 0 0 0 12 2 2 2 2 2 2 2 2 2 27 5 5 5 5 5 5 5 5 5 5 5 5 5 5 5 5 5 5 5 5 5 4 4 4 3 3 3 2 2 2 2
2 2 2 2 2 2 2 2 2 2 18 14 15 16 17 17 17 17 17 17 17 17 17 17 17 17 17 17 16 14 14 22 2 2 2 2 2 2 2 2 2 7 6 6 6 6 6 6 6 6 0 0 0 6 6 6 6 6 6 6 6 13 2 2 2 2 2 2 2 2 2 27 5 5 5 5 5 5 5 5 5 5 5 5 5 5 5 5 5 5 5 5 5 4 4 4 3 3 3 2 2 2 2
2 2 2 2 2 2 2 2 2 2 18 14 14 15 16 16 17 17 17 17 17 17 17 17 17 17 17 15 15 14 14 22 2 2 2 2 2 2 2 2 2 2 2 2 2 2 2 2 2 2 0 0 0 2 2 2 2 2 2 2 2 2 2 2 2 2 2 2 2 2 2 27 5 5 5 5 5 5 5 5 5 5 5 5 5 5 5 5 5 5 5 5 4 4 4 3 3 3 2 2 2 2 2
2 2 2 2 2 2 2 2 2 2 18 14 15 16 17 17 17 17 17 17 17 17 17 17 17 17 17 17 16 15 14 22 2 2 2 2 2 2 2 2 2 2 2 2 2 2 2 2 2 2 0 0 0 2 2 2 2 2 2 2 2 2 2 2 2 2 2 2 2 2 2 27 5 5 5 5 5 5 5 5 5 5 5 5 5 5 5 5 5 5 5 4 4 4 3 3 3 2 2 2 2 2 2
2 2 2 2 2 2 2 2 2 2 18 14 15 16 17 17 17 17 17 17 17 17 17 17 17 17 17 17 16 15 14 22 2 2 2 2 2 2 2 2 2 2 2 2 2 2 2 2 2 2 0 0 0 2 2 2 2 2 2 2 2 2 2 2 2 2 2 2 2 2 2 26 30 30 30 30 30 30 30 30 30 5 5 5 30 30 30 30 30 30 30 30 30 2 2 2 2 2 2 2 2 2 2
2 2 2 2 2 2 2 2 2 2 18 14 15 15 16 17 17 17 17 17 17 17 17 17 17 17 17 17 16 15 14 22 2 2 2 2 2 2 2 2 2 2 2 2 2 2 2 2 2 2 0 0 0 2 2 2 2 2 2 2 2 2 2 2 2 2 2 2 2 2 2 2 2 2 2 2 2 2 2 2 2 5 5 5 2 2 2 2 2 2 2 2 2 2 2 2 2 2 2 2 2 2 2 
2 2 2 2 2 2 2 2 2 2 18 14 14 15 16 17 17 17 17 17 17 17 17 17 17 17 17 17 16 14 14 22 2 2 2 2 2 2 2 2 2 2 2 2 2 2 2 2 2 2 0 0 0 2 2 2 2 2 2 2 2 2 2 2 2 2 2 2 2 2 2 2 2 2 2 2 2 2 2 2 2 5 5 5 2 2 2 2 2 2 2 2 2 2 2 2 2 2 2 2 2 2 2
2 2 2 2 2 2 2 2 2 2 18 14 14 16 17 17 17 17 17 17 17 17 17 17 17 17 17 17 16 14 14 22 2 2 2 2 2 2 2 2 2 2 2 2 2 2 2 2 2 2 0 0 0 2 2 2 2 2 2 2 2 2 2 2 2 2 2 2 2 2 2 2 2 2 2 2 2 2 2 2 2 5 5 5 2 2 2 2 2 2 2 2 2 2 2 2 2 2 2 2 2 2 2
2 2 2 2 2 2 2 2 2 2 18 14 15 15 16 17 17 17 17 17 17 17 17 17 17 17 17 16 15 15 14 22 2 2 2 2 2 2 2 2 2 2 2 2 2 2 2 2 2 2 0 0 0 2 2 2 2 2 2 2 2 2 2 2 2 2 2 2 3 3 3 3 3 3 3 3 3 3 3 3 3 5 5 5 2 2 2 2 2 2 2 2 2 2 2 2 2 2 2 2 2 2 2
2 2 2 2 2 2 2 2 2 2 18 14 15 16 17 17 17 17 17 17 17 17 17 17 17 17 17 15 15 14 14 22 2 2 2 2 2 2 2 2 2 2 2 2 2 2 2 2 2 2 0 0 0 2 2 2 2 2 2 2 2 2 2 2 2 2 2 2 3 3 4 4 4 4 4 4 4 4 4 4 5 5 5 5 29 29 29 29 29 29 29 29 29 2 2 2 2 2 2 2 2 2 2
2 2 2 2 2 2 2 2 2 2 18 14 14 15 16 16 17 17 17 17 17 17 17 17 17 17 17 17 16 15 14 22 2 2 2 2 2 2 2 2 2 9 10 10 10 10 10 10 10 10 0 0 0 10 10 10 10 10 10 10 10 11 2 2 2 2 2 2 3 3 4 4 4 0 0 4 0 0 4 5 5 5 5 5 5 5 5 5 5 5 5 5 5 4 4 4 3 3 3 2 2 2 2
2 2 2 2 2 2 2 2 2 2 18 14 15 16 17 17 17 17 17 17 17 17 17 17 17 17 17 17 16 14 14 22 2 2 2 2 2 2 2 2 2 8 0 0 0 0 0 0 0 0 0 0 0 0 0 0 0 0 0 0 0 12 2 2 2 2 2 2 3 3 4 4 0 5 5 5 5 5 5 5 5 5 5 5 5 5 5 5 5 5 5 5 5 4 4 4 3 3 3 2 2 2 2
2 2 2 2 2 2 2 2 2 2 18 14 16 16 17 17 17 17 17 17 17 17 17 17 17 17 17 17 16 16 14 22 2 2 2 2 2 2 2 2 2 8 0 0 0 0 0 0 0 0 0 0 0 0 0 0 0 0 0 0 0 12 2 2 2 2 2 2 3 3 4 4 0 5 5 5 5 5 5 5 5 5 5 5 5 5 5 5 5 5 5 5 4 4 4 3 3 3 2 2 2 2 2
2 2 2 2 2 2 2 2 2 2 18 14 16 17 17 17 17 17 17 17 17 17 17 17 17 17 17 17 17 16 14 22 2 2 2 2 2 2 2 2 2 8 0 0 0 0 0 0 0 0 0 0 0 0 0 0 0 0 0 0 0 12 2 2 2 2 2 2 3 3 4 4 4 5 5 5 5 5 5 5 5 5 5 5 5 5 5 5 5 5 5 5 5 4 4 4 3 3 3 2 2 2 2
2 2 2 2 2 2 2 2 2 2 18 14 16 17 17 17 17 17 17 17 17 17 17 17 17 17 17 17 17 16 14 22 2 2 2 2 2 2 2 2 2 8 0 0 0 0 0 0 0 0 0 0 0 0 0 0 0 0 0 0 0 12 2 2 2 2 2 2 3 3 4 4 0 5 5 5 5 5 5 5 5 5 5 5 5 5 5 5 5 5 5 5 5 4 4 4 3 3 3 2 2 2 2
2 2 2 2 2 2 2 2 2 2 18 14 16 17 17 17 17 17 17 17 17 17 17 17 17 17 17 17 17 16 14 22 2 2 2 2 2 2 2 2 2 8 0 0 0 0 0 0 0 0 0 0 0 0 0 0 0 0 0 0 0 12 2 2 2 2 2 2 3 3 4 4 0 5 5 5 5 5 5 5 5 5 5 5 5 5 5 5 5 5 5 5 4 4 4 3 3 3 2 2 2 2 2
2 2 2 2 2 2 2 2 2 2 18 14 16 17 17 17 17 17 17 17 17 17 17 17 17 17 17 17 17 16 14 22 2 2 2 2 2 2 2 2 2 8 0 0 0 0 0 0 0 0 0 0 0 0 0 0 0 0 0 0 0 12 2 2 2 2 2 2 3 3 4 4 0 5 5 5 5 5 5 5 5 5 5 5 5 5 5 5 5 5 5 5 4 4 4 3 3 3 2 2 2 2 2
2 2 2 2 2 2 2 2 2 2 18 14 16 17 17 17 17 17 17 17 17 17 17 17 17 17 17 17 17 16 14 14 14 14 14 14 14 14 0 0 0 0 0 0 0 0 0 0 0 0 0 0 0 0 0 0 0 0 0 0 0 0 0 0 0 0 0 0 5 5 5 5 5 5 5 5 5 5 5 5 5 5 5 5 5 5 5 5 5 5 5 5 5 4 4 4 3 3 3 2 2 2 2
2 2 2 2 2 2 2 2 2 2 18 14 16 17 17 17 17 17 17 17 17 17 17 17 17 17 17 17 17 16 14 14 14 14 14 14 14 14 0 0 0 0 0 0 0 0 0 0 0 0 0 0 0 0 0 0 0 0 0 0 0 0 0 0 0 0 0 0 5 5 5 5 5 5 5 5 5 5 5 5 5 5 5 5 5 5 5 5 5 5 5 5 4 4 4 3 3 3 2 2 2 2 2
2 2 2 2 2 2 2 2 2 2 18 14 16 17 17 17 17 17 17 17 17 17 17 17 17 17 17 17 17 16 14 14 14 14 14 14 14 14 0 0 0 0 0 0 0 0 0 0 0 0 0 0 0 0 0 0 0 0 0 0 0 0 0 0 0 0 0 0 5 5 5 5 5 5 5 5 5 5 5 5 5 5 5 5 5 5 5 5 5 5 5 5 4 4 4 3 3 3 2 2 2 2 2
2 2 2 2 2 2 2 2 2 2 18 14 16 17 17 17 17 17 17 17 17 17 17 17 17 17 17 17 17 16 14 22 2 2 2 2 2 2 2 2 2 8 0 0 0 0 0 0 0 0 0 0 0 0 0 0 0 0 0 0 0 12 2 2 2 2 2 2 2 2 2 27 5 5 5 5 5 5 5 5 5 5 5 5 5 5 5 5 5 5 5 4 4 4 3 3 3 2 2 2 2 2 2
2 2 2 2 2 2 2 2 2 2 18 14 16 17 17 17 17 17 17 17 17 17 17 17 17 17 17 17 17 16 14 22 2 2 2 2 2 2 2 2 2 8 0 0 0 0 0 0 0 0 0 0 0 0 0 0 0 0 0 0 0 12 2 2 2 2 2 2 2 2 2 27 5 5 5 5 5 5 5 5 5 5 5 5 5 5 5 5 5 5 5 5 4 4 4 3 3 3 2 2 2 2 2
2 2 2 2 2 2 2 2 2 2 18 14 16 17 17 17 17 17 17 17 17 17 17 17 17 17 17 17 17 16 14 22 2 2 2 2 2 2 2 2 2 8 0 0 0 0 0 0 0 0 0 0 0 0 0 0 0 0 0 0 0 12 2 2 2 2 2 2 2 2 2 27 5 5 5 5 5 5 5 5 5 5 5 5 5 5 5 5 5 5 5 4 4 4 3 3 3 2 2 2 2 2 2
2 2 2 2 2 2 2 2 2 2 18 14 16 17 17 17 17 17 17 17 17 17 17 17 17 17 17 17 17 16 14 22 2 2 2 2 2 2 2 2 2 8 0 0 0 0 0 0 0 0 0 0 0 0 0 0 0 0 0 0 0 12 2 2 2 2 2 2 2 2 2 27 5 5 5 5 5 5 5 5 5 5 5 5 5 5 5 5 5 5 5 4 4 4 3 3 3 2 2 2 2 2 2
2 2 2 2 2 2 2 2 2 2 18 16 16 16 17 17 17 17 17 17 17 17 17 17 17 17 17 17 16 15 14 22 2 2 2 2 2 2 2 2 2 8 0 0 0 0 0 0 0 0 0 0 0 0 0 0 0 0 0 0 0 12 2 2 2 2 2 2 2 2 2 27 31 31 31 31 31 31 31 31 31 31 31 31 31 31 31 31 31 31 5 5 4 4 4 3 3 3 2 2 2 2 2
2 2 2 2 2 2 2 2 2 2 18 14 15 16 17 17 17 17 17 17 17 17 17 17 17 17 17 17 16 15 14 22 2 2 2 2 2 2 2 2 2 8 0 0 0 0 0 0 0 0 0 0 0 0 0 0 0 0 0 0 0 12 2 2 2 2 2 2 2 2 2 27 31 31 31 31 31 31 31 31 31 31 31 31 31 31 31 31 31 31 5 4 4 4 3 3 3 2 2 2 2 2 2
2 2 2 2 2 2 2 2 2 2 18 14 14 15 16 16 17 17 17 17 17 17 17 17 17 17 17 16 15 15 14 22 2 2 2 2 2 2 2 2 2 7 6 6 6 6 6 6 6 6 0 0 0 6 6 6 6 6 6 6 6 13 2 2 2 2 2 2 2 2 2 27 31 31 31 31 31 31 31 31 31 31 31 31 31 31 31 31 31 31 5 5 5 4 4 4 3 3 3 2 2 2 2
2 2 2 2 2 2 2 2 2 2 18 14 15 16 17 17 17 17 17 17 17 17 17 17 17 17 17 16 15 15 14 22 2 2 2 2 2 2 2 2 2 2 2 2 2 2 2 2 2 2 0 0 0 2 2 2 2 2 2 2 2 2 2 2 2 2 2 2 2 2 2 27 31 31 31 31 31 31 31 31 31 31 31 31 31 31 31 31 31 31 5 5 5 4 4 4 3 3 3 2 2 2 2
2 2 2 2 2 2 2 2 2 2 18 14 15 16 17 17 17 17 17 17 17 17 17 17 17 17 17 16 16 15 14 22 2 2 2 2 2 2 2 2 2 2 2 2 2 2 2 2 2 2 0 0 0 2 2 2 2 2 2 2 2 2 2 2 2 2 2 2 2 2 2 27 31 31 31 31 31 31 31 31 31 31 31 31 31 31 31 31 31 31 5 5 5 4 4 4 3 3 3 2 2 2 2
2 2 2 2 2 2 2 2 2 2 18 14 15 15 16 17 17 17 17 17 17 17 17 17 17 17 17 17 15 14 14 22 2 2 2 2 2 2 2 2 2 2 2 2 2 2 2 2 2 2 0 0 0 2 2 2 2 2 2 2 2 2 2 2 2 2 2 2 2 2 2 27 31 31 31 31 31 31 31 31 31 31 31 31 31 31 31 31 31 31 5 5 5 4 4 4 3 3 3 2 2 2 2
2 2 2 2 2 2 2 2 2 2 18 14 14 15 16 17 17 17 17 17 17 17 17 17 17 17 17 17 16 16 14 22 2 2 2 2 2 2 2 2 2 2 2 2 2 2 2 2 2 2 0 0 0 2 2 2 2 2 2 2 2 2 2 2 2 2 2 2 2 2 2 27 31 31 31 31 31 31 31 31 31 31 31 31 31 31 31 31 31 31 5 4 4 4 3 3 3 2 2 2 2 2 2
2 2 2 2 2 2 2 2 2 2 18 14 14 16 17 17 17 17 17 17 17 17 17 17 17 17 17 16 16 15 14 22 2 2 2 2 2 2 2 2 2 2 2 2 2 2 2 2 2 2 0 0 0 2 2 2 2 2 2 2 2 2 2 2 2 2 2 2 2 2 2 27 31 31 31 31 31 31 31 31 31 31 31 31 31 31 31 31 31 31 5 4 4 4 3 3 3 2 2 2 2 2 2
2 2 2 2 2 2 2 2 2 2 18 14 15 15 16 17 17 17 17 17 17 17 17 17 17 17 17 16 15 15 14 22 2 2 2 2 2 2 2 2 2 2 2 2 2 2 2 2 2 2 0 0 0 2 2 2 2 2 2 2 2 2 2 2 2 2 2 2 2 2 2 27 31 31 31 31 31 31 31 31 31 31 31 31 31 31 31 31 31 31 5 4 4 4 3 3 3 2 2 2 2 2 2
2 2 2 2 2 2 2 2 2 2 18 14 15 16 17 17 17 17 17 17 17 17 17 17 17 17 17 16 16 15 14 22 2 2 2 2 2 2 2 2 2 2 2 2 2 2 2 2 2 2 0 0 0 2 2 2 2 2 2 2 2 2 2 2 2 2 2 2 2 2 2 27 31 31 31 31 31 31 31 31 31 31 31 31 31 31 31 31 31 31 5 5 4 4 4 3 3 3 2 2 2 2 2
2 2 2 2 2 2 2 2 2 2 18 14 14 15 16 16 17 17 17 17 17 17 17 17 17 17 17 17 15 14 14 22 2 2 2 2 2 2 2 2 2 9 10 10 10 10 10 10 10 10 0 0 0 10 10 10 10 10 10 10 10 11 2 2 2 2 2 2 2 2 2 27 31 31 31 31 31 31 31 31 31 31 31 31 31 31 31 31 31 31 5 5 4 4 4 3 3 3 2 2 2 2 2
2 2 2 2 2 2 2 2 2 2 18 14 14 14 14 14 14 14 14 14 14 14 14 14 14 14 14 14 14 14 14 22 2 2 2 2 2 2 2 2 2 8 0 0 0 0 0 0 0 0 0 0 0 0 0 0 0 0 0 0 0 12 2 2 2 2 2 2 2 2 2 27 31 31 31 31 31 31 31 31 31 31 31 31 31 31 31 31 31 31 5 4 4 4 3 3 3 2 2 2 2 2 2
2 2 2 2 2 2 2 2 2 2 24 23 23 23 23 23 23 23 23 23 23 23 23 23 23 23 23 23 23 23 23 25 2 2 2 2 2 2 2 2 2 8 0 0 0 0 0 0 0 0 0 0 0 0 0 0 0 0 0 0 0 12 2 2 2 2 2 2 2 2 2 27 31 31 31 31 31 31 31 31 31 31 31 31 31 31 31 31 31 31 5 4 4 4 3 3 3 2 2 2 2 2 2
2 2 2 2 2 2 2 2 2 2 2 2 2 2 2 2 2 2 2 2 2 2 2 2 2 2 2 2 2 2 2 2 2 2 2 2 2 2 2 2 2 8 0 0 0 0 0 0 0 0 0 0 0 0 0 0 0 0 0 0 0 12 2 2 2 2 2 2 2 2 2 27 31 31 31 31 31 31 31 31 31 31 31 31 31 31 31 31 31 31 5 5 4 4 4 3 3 3 2 2 2 2 2
2 2 2 2 2 2 2 2 2 2 2 2 2 2 2 2 2 2 2 2 2 2 2 2 2 2 2 2 2 2 2 2 2 2 2 2 2 2 2 2 2 8 0 0 0 0 0 0 0 0 0 0 0 0 0 0 0 0 0 0 0 12 2 2 2 2 2 2 2 2 2 27 31 31 31 31 31 31 31 31 31 31 31 31 31 31 31 31 31 31 5 5 4 4 4 3 3 3 2 2 2 2 2
2 2 2 2 2 2 2 2 2 2 2 2 2 2 2 2 2 2 2 2 2 2 2 2 2 2 2 2 2 2 2 2 2 2 2 2 2 2 2 2 2 8 0 0 0 0 0 0 0 0 0 0 0 0 0 0 0 0 0 0 0 12 2 2 2 2 2 2 2 2 2 27 31 31 31 31 31 31 31 31 31 31 31 31 31 31 31 31 31 31 5 4 4 4 3 3 3 2 2 2 2 2 2
2 2 2 2 2 2 2 2 2 2 2 2 2 2 2 2 2 2 2 2 2 2 2 2 2 2 2 2 2 2 2 2 2 2 2 2 2 2 2 2 2 8 0 0 0 0 0 0 0 0 0 0 0 0 0 0 0 0 0 0 0 12 2 2 2 2 2 2 2 2 2 27 31 31 31 31 31 31 31 31 31 31 31 31 31 31 31 31 31 31 5 4 4 4 3 3 3 2 2 2 2 2 2
2 2 2 2 2 2 2 2 2 2 2 2 2 2 2 2 2 2 2 2 2 2 2 2 2 2 2 2 2 2 2 2 2 2 2 2 2 2 2 2 2 8 0 0 0 0 0 0 0 0 0 0 0 0 0 0 0 0 0 0 0 12 2 2 2 2 2 2 2 2 2 27 31 31 31 31 31 31 31 31 31 31 31 31 31 31 31 31 31 31 5 4 4 4 3 3 3 2 2 2 2 2 2
2 2 2 2 2 2 2 2 2 2 2 2 2 2 2 2 2 2 2 2 2 2 2 2 2 2 2 2 2 2 2 2 2 2 2 2 2 2 2 2 2 8 0 0 0 0 0 0 0 0 0 0 0 0 0 0 0 0 0 0 0 12 2 2 2 2 2 2 2 2 2 26 30 30 30 30 30 30 30 30 30 30 30 30 30 30 30 30 30 30 30 30 30 2 2 2 2 2 2 2 2 2 2
2 2 2 2 2 2 2 2 2 2 2 2 2 2 2 2 2 2 2 2 2 2 2 2 2 2 2 2 2 2 2 2 2 2 2 2 2 2 2 2 2 8 0 0 0 0 0 0 0 0 0 0 0 0 0 0 0 0 0 0 0 12 2 2 2 2 2 2 2 2 2 2 2 2 2 2 2 2 2 2 2 2 2 2 2 2 2 2 2 2 2 2 2 2 2 2 2 2 2 2 2 2 2
2 2 2 2 2 2 2 2 2 2 19 20 20 20 20 20 20 20 20 20 20 20 20 20 20 20 20 20 20 20 20 21 2 2 2 2 2 2 2 2 2 8 0 0 0 0 0 0 0 0 0 0 0 0 0 0 0 0 0 0 0 12 2 2 2 2 2 2 2 2 2 2 2 2 2 2 2 2 2 2 2 2 2 2 2 2 2 2 2 2 2 2 2 2 2 2 2 2 2 2 2 2 2
2 2 2 2 2 2 2 2 2 2 18 14 14 14 14 14 14 14 14 14 14 14 14 14 14 14 14 14 14 14 14 22 2 2 2 2 2 2 2 2 2 8 0 0 0 0 0 0 0 0 0 0 0 0 0 0 0 0 0 0 0 12 2 2 2 2 2 2 2 2 2 2 2 2 2 2 2 2 2 2 2 2 2 2 2 2 2 2 2 2 2 2 2 2 2 2 2 2 2 2 2 2 2
2 2 2 2 2 2 2 2 2 2 18 14 16 16 16 16 16 16 16 16 16 16 16 16 16 16 16 16 16 16 14 22 2 2 2 2 2 2 2 2 2 8 0 0 0 0 0 0 0 0 0 0 0 0 0 0 0 0 0 0 0 12 2 2 2 2 2 2 2 2 2 2 2 2 2 2 2 2 2 2 2 2 2 2 2 2 2 2 2 2 2 2 2 2 2 2 2 2 2 2 2 2 2
2 2 2 2 2 2 2 2 2 2 18 14 16 17 17 17 17 17 17 17 17 17 17 17 17 17 17 17 17 16 14 22 2 2 2 2 2 2 2 2 2 8 0 0 0 0 0 0 0 0 0 0 0 0 0 0 0 0 0 0 0 12 2 2 2 2 2 2 2 2 2 2 2 2 2 2 2 2 2 2 2 2 2 2 2 2 2 2 2 2 2 2 2 2 2 2 2 2 2 2 2 2 2
2 2 2 2 2 2 2 2 2 2 18 14 16 16 16 16 16 16 16 16 16 16 16 16 16 16 16 16 16 16 14 22 2 2 2 2 2 2 2 2 2 8 0 0 0 0 0 0 0 0 0 0 0 0 0 0 0 0 0 0 0 12 2 2 2 2 2 2 2 2 2 2 2 2 2 2 2 2 2 2 2 2 2 2 2 2 2 2 2 2 2 2 2 2 2 2 2 2 2 2 2 2 2
2 2 2 2 2 2 2 2 2 2 18 14 14 14 14 14 14 14 14 14 14 14 14 14 14 14 14 14 14 14 14 22 2 2 2 2 2 2 2 2 2 8 0 0 0 0 0 0 0 0 0 0 0 0 0 0 0 0 0 0 0 12 2 2 2 2 2 2 2 2 2 2 2 2 2 2 2 2 2 2 2 2 2 2 2 2 2 2 2 2 2 2 2 2 2 2 2 2 2 2 2 2 2
2 2 2 2 2 2 2 2 2 2 24 23 23 23 23 23 23 23 23 23 23 23 23 23 23 23 23 23 23 23 23 25 2 2 2 2 2 2 2 2 2 7 6 6 6 6 6 6 6 6 6 6 6 6 6 6 6 6 6 6 6 13 2 2 2 2 2 2 2 2 2 2 2 2 2 2 2 2 2 2 2 2 2 2 2 2 2 2 2 2 2 2 2 2 2 2 2 2 2 2 2 2 2
2 2 2 2 2 2 2 2 2 2 2 2 2 2 2 2 2 2 2 2 2 2 2 2 2 2 2 2 2 2 2 2 2 2 2 2 2 2 2 2 2 2 2 2 2 2 2 2 2 2 2 2 2 2 2 2 2 2 2 2 2 2 2 2 2 2 2 2 2 2 2 2 2 2 2 2 2 2 2 2 2 2 2 2 2 2 2 2 2 2 2 2 2 2 2 2 2 2 2 2 2 2 2
2 2 2 2 2 2 2 2 2 2 2 2 2 2 2 2 2 2 2 2 2 2 2 2 2 2 2 2 2 2 2 2 2 2 2 2 2 2 2 2 2 2 2 2 2 2 2 2 2 2 2 2 2 2 2 2 2 2 2 2 2 2 2 2 2 2 2 2 2 2 2 2 2 2 2 2 2 2 2 2 2 2 2 2 2 2 2 2 2 2 2 2 2 2 2 2 2 2 2 2 2 2 2
2 2 2 2 2 2 2 2 2 2 2 2 2 2 2 2 2 2 2 2 2 2 2 2 2 2 2 2 2 2 2 2 2 2 2 2 2 2 2 2 2 2 2 2 2 2 2 2 2 2 2 2 2 2 2 2 2 2 2 2 2 2 2 2 2 2 2 2 2 2 2 2 2 2 2 2 2 2 2 2 2 2 2 2 2 2 2 2 2 2 2 2 2 2 2 2 2 2 2 2 2 2 2
2 2 2 2 2 2 2 2 2 2 2 2 2 2 2 2 2 2 2 2 2 2 2 2 2 2 2 2 2 2 2 2 2 2 2 2 2 2 2 2 2 2 2 2 2 2 2 2 2 2 2 2 2 2 2 2 2 2 2 2 2 2 2 2 2 2 2 2 2 2 2 2 2 2 2 2 2 2 2 2 2 2 2 2 2 2 2 2 2 2 2 2 2 2 2 2 2 2 2 2 2 2 2
2 2 2 2 2 2 2 2 2 2 2 2 2 2 2 2 2 2 2 2 2 2 2 2 2 2 2 2 2 2 2 2 2 2 2 2 2 2 2 2 2 2 2 2 2 2 2 2 2 2 2 2 2 2 2 2 2 2 2 2 2 2 2 2 2 2 2 2 2 2 2 2 2 2 2 2 2 2 2 2 2 2 2 2 2 2 2 2 2 2 2 2 2 2 2 2 2 2 2 2 2 2 2
2 2 2 2 2 2 2 2 2 2 2 2 2 2 2 2 2 2 2 2 2 2 2 2 2 2 2 2 2 2 2 2 2 2 2 2 2 2 2 2 2 2 2 2 2 2 2 2 2 2 2 2 2 2 2 2 2 2 2 2 2 2 2 2 2 2 2 2 2 2 2 2 2 2 2 2 2 2 2 2 2 2 2 2 2 2 2 2 2 2 2 2 2 2 2 2 2 2 2 2 2 2 2
2 2 2 2 2 2 2 2 2 2 2 2 2 2 2 2 2 2 2 2 2 2 2 2 2 2 2 2 2 2 2 2 2 2 2 2 2 2 2 2 2 2 2 2 2 2 2 2 2 2 2 2 2 2 2 2 2 2 2 2 2 2 2 2 2 2 2 2 2 2 2 2 2 2 2 2 2 2 2 2 2 2 2 2 2 2 2 2 2 2 2 2 2 2 2 2 2 2 2 2 2 2 2
2 2 2 2 2 2 2 2 2 2 2 2 2 2 2 2 2 2 2 2 2 2 2 2 2 2 2 2 2 2 2 2 2 2 2 2 2 2 2 2 2 2 2 2 2 2 2 2 2 2 2 2 2 2 2 2 2 2 2 2 2 2 2 2 2 2 2 2 2 2 2 2 2 2 2 2 2 2 2 2 2 2 2 2 2 2 2 2 2 2 2 2 2 2 2 2 2 2 2 2 2 2 2
